24 13
200 100
12 10 10 10 10 10 10 10 10 10 10 10 10 10 10 10 10 10 10 12 14 14 14 14

12 11 11 11 11 11 11 11 11 11 11 11 11 11 11 11 11 11 11 12 10 10 12 14

12 14 14 14 14 14 14 14 14 14 14 14 14 14 14 14 14 14 14 12 11 11 11 14

12 14 14 14 14 14 14 14 14 14 14 14 14 14 14 14 14 14 14 14 14 14 14 14

12 14 14 14 14 14 14 14 14 14 14 14 14 14 14 14 14 14 14 14 14 14 14 14

12 10 10 10 10 10 10 10 10 14 14 10 10 10 10 10 10 10 10 12 10 10 10 14

12 11 11 11 11 11 11 11 11 14 14 11 11 11 11 11 11 11 11 12 11 11 11 14

12 14 14 14 14 14 14 14 14 14 14 14 14 14 14 14 14 14 14 12 14 14 14 14

12 14 14 14 14 14 14 14 14 14 14 14 14 14 14 14 14 14 14 12 14 14 14 14

12 14 14 14 14 14 14 14 14 14 14 14 14 14 14 14 14 14 14 12 14 14 14 14

12 14 14 14 14 14 14 14 14 14 14 14 14 14 14 14 14 14 14 12 14 14 14 14

12 10 10 10 10 10 10 10 10 10 10 10 10 10 10 10 10 10 10 12 14 14 14 14

12 11 11 11 11 11 11 11 11 11 11 11 11 11 11 11 11 11 11 12 14 14 14 14